10/10
0,0,0,0,0,0,0,0,0,0
0,1,1,1,2,1,1,1,1,1
0,1,2,2,1,1,1,1,2,2
0,1,3,3,2,2,2,2,2,2
0,1,1,2,2,2,2,2,2,2
0,0,1,1,2,2,3,3,3,4
0,0,1,1,2,1,2,2,3,4
0,0,0,0,1,1,2,2,2,3
0,0,0,0,0,1,1,2,2,2
0,0,0,0,0,1,1,1,2,2

_,_,_,_,_,_,_,_,_,_
_,E,_,_,_,E,_,_,_,_
_,R,_,_,_,_,_,_,_,_
_,_,_,_,_,_,R,_,_,_
_,_,_,_,_,_,_,_,_,_
_,_,_,R,E,_,_,_,_,E
_,E,_,_,_,_,_,_,_,_
_,_,_,_,_,_,E,_,R,_
_,_,_,_,R,_,_,_,_,_
P,_,_,_,_,_,_,_,_,_
