10/10
0,0,0,0,0,0,0,0,0,0
0,0,0,0,0,0,0,0,0,0
0,0,1,2,3,4,5,0,0,0
0,0,0,0,0,0,0,0,0,0
0,0,0,0,0,0,0,0,0,0
0,0,0,0,0,0,0,0,0,0
0,0,0,0,0,0,0,0,0,0
0,0,0,0,0,0,0,0,0,0
0,0,0,0,0,0,0,0,0,0
0,0,0,0,0,0,0,0,0,0

_,_,_,_,_,_,_,_,_,_
_,_,_,_,_,_,_,_,_,_
_,P,_,_,_,_,_,_,_,_
_,_,_,_,_,_,_,_,_,_
_,_,_,P,R,_,_,_,_,_
_,_,_,_,_,_,_,_,_,_
_,_,_,_,_,_,_,_,_,_
_,_,_,_,_,_,_,_,_,_
_,_,_,_,_,_,_,_,_,_
_,_,_,_,_,_,_,_,_,_
